|||||||||||||||||||||||||||||
|                           |
|                           |
|      ||||||||||||||||     |
|                     |     |
|                     |     |
|||||  |  | |||X|||   | |||||
    |  |  | |     |   | |
    |  |  | |     |   | |
|||||  |  | |||||||   | |||||
          |           |
|   |      ||||||||||| |    |
|   |                  |    |
|   ||||||||||||||||||||    |
|                           |
|||||||||||||||||||||||||||||